# 12.01.24
Тестирование ПО - Процесс анализа програмного средства и сопутствующей документации с целью выявления деффектов и повышения качества продукта
Требование - описание того, какие функции и соблюдение условий должно выполнять
# 17.01.24
Модульное тестирование - проверка атомарных частей кода (методов, классов, функциий, методов классов)
Интеграционное тестирование - проверка взаимосвязей компонентов между собой и их интеграиции с системой
Системное тестирование - проверка взаимодействия тестируемого ПО с системой по функциональным и нефункциональным требованиям с максимально приближенным окружением, которое у конечного пользователя
Приемочное тестирование (E2E, сквозное) - тестирование, во время которого происходит валидация требований
Черный ящик - тестирование без доступа к внутренней системе (не видя код)
Белый ящик - тестирование зная внутреннюю структуру программы или системы  (видя код)
Серый ящик - тестирование частично зная внутреннюю структуру программы или системы (частично видя код)
Функциональное тестирование - тестирование, которое основывается на функциях и особенностях, а также на взаимодействии с другими системами
Тестирование производительности - тестирование, задачей которого является определение масштабирования приложения под нагрузкой
Тестирование установки - тестирование, которое направлено на проверку успешной установки и настройки а также на обновление и удаление ПО
Тестирование пользовательского интерфейса - тестирование, во время которого проверяется взаимодействие человека и ПО
Тестирование на отказ и восстановление - тестирование во время которого проверяется способность на отказ и успешность восстановления после сбоев
Конфигурационное тестирование - тестирование во время которого проверяется работа ПО в различных конфигурациях системы
Регрессионное тестирование - тестирование которое направленно на проверку изменений, сделанных в приложении для подтверждения того что существующая функциональность работает как прежде
Тестирование сборки - тестирование которое проверяет соответствие выпущенной версии критериям качества
Санитарное тестирование или проверка согласованности/исправности - тестирование которое доказывает то, что конкретная функция работает согласно заявленным спецификациям требований
Автоматизированное тестирование - тестирование с использование специального ПО
Альфа тестирование - приемочное тестирование на поздней стадии и включает иммитацию реального использования
Бета тестирование - интенсивное использование почти готовой версии продукта
Гамма-тестирование - финальная стадия тестирования перед выпуском продукта
Позитивное тестирование - проверка работы системы на соответствие ее нормальному поведению согласно ТЗ
Негативное тестирование - тестирование системы на нештатное поведение
Жизненный цикл тестирования (ЖЦ STLC) - процесс тестирования, которое включает в себя определенную последовательность шагов, чтобы гарантировать достижение цели в области качества
Кпритерии начала - набор условий для продолжения процесса с определенной задачей
# 30.01.24
Критерии окончания/выхода - набор условий для того чтобы процесс мог считаться завершенным
Тест-план - вид тестовой документации, который отвечает на вопросы: что тестировать? где тестировать? когда тестировать? как тестировать?
Чек-лист - документ содержащий список проверок необходимых в рамках тестирования
Тест-кейс - документ, который описывает последовательность шагов, условий и параметров, необходимых для проверки объекта тестирования
Отчет по тестированию - содержит подробные ответы на вопросы: что тестировать? где тестировать? когда тестировать? как тестировать?
Тест-сьют - набор тест-кейсов, объедененный одним модулем, функциональностью, приоритетом и т.д.
Баг-репорт- отчет об ошибках
# 06.02.24
Тест-дизайн - этап процесса тестирования ПО на котором проектируются и создаются тест-кейсы, в соответствии с определенными ранее критериями качества и целями тестирования
Покрытие требований - оценка покрытия тестами функциональных и нефункциональных требований к продукту, путем построения матриц трассировки
Покрытие кода - оценка покрытия исполняемого кода тестами, путем отслеживания непроверенных в процессе тестирования частей ПО
Тестовое покрытие - на базе анализа потока управления - оценка покрытием основанное на определении путей выполнения кода программного модуля и создания выполняемых тест-кейсов для покрытия этих путей
# 16.02.24
Верификация - процесс оценки системы или ее компонентов с целью определения того, удовлетворяют ли результаты текущего этапа разработки условиям сформированным в начале этого этапа
Валидация - Определение соответвия разрабатываемого ПО ожиданиям и потребностям пользователя, требованиям системы
Валидация сайта - проверка соответствия программного кода ресурсам всем установленным и общепринятым нормам разработки, верстки и веб-дизайна
# 20.02.24
PHP Unit - библиотека для проведения модульных тестов
Composer - пакетный менеджер зависимостей, предназначенный для упрощения загрузки и установки сторонних php библиотек в проект
# 12.03.24
Пользовательский интерфейс - совокупность средств и методов, при помощи которых пользователь взаимодействует с различными машинами, устройствами и аппаратурой
Графический интерфейс пользователя - разновидность интерфейса, обеспечивающая взаимодействие через графические элементы(меню, кнопки, значки и т.д.)
Распознавание образа - подход использующий механизмы реализации специальных возможностей (accessebility) и особенности реализации некоторых UI-фреймворков
# 10.05.24
Нагрузка на сайт - Количество запросов, которое поступает на сервер веб-приложения в единицу времени
Тестирование нагрузки сайта - процесс проверки производительности с помощью симуляции повышенного количества запросов
Стрессовое тестирование - вид тестирования, в ходе которого производится проверка производительности веб-приложения при экстримально высоких нагрузках
Объемное тестирование - вид тестирования, в котором производится проверка производительности веб-приложения при работе с большим объемом данных
Тестирование стабильности/надежности - вид тестирования, в котором производится проверка производительности веб-приложения при продолжительной работе
# 14.05.24
Тестирование безопастности - тестирование в котором необходимо найти и устранить уяхвимости в веб-приложении до того, как ими воспользуются злоумышленники
Конфиденциальность - посторонние пользователи не могут прочитать какие-либо данные
Целостность - Неавторизованные пользователи не могут писать данные
Доступность - система должна быть доступна авторизованным пользователям для чтения и записи данных

